1111111111111111111111111111111111111111111111111111111111111111111111111111111111111111111111111111
1P00000000000000000000000000000000000000C11000010101000011000001010001100010010011110010011010100111
1100000111000010111101010000001110001010001100111011101000111111000010001000000100010100000110110111
1010010111000101010010001010100011111011010101111000111111101000100000100010100110011100000100000011
1000101010011101111000011101111000101110011111010001110001111100010000000111001001111110000110010111
1101010100000000100000011001101011000000000001110111010110010101111001100101101000101111110110001111
1101110010000101000101110010001101001100001101100100000001110011100100000001010110100100100110100001
1110000000011101001101110001101100011001110111100011100000011000000011011011111110101000111010100101
1001110000000011101000011001000000110100001000000110101010001111011100000000011000111000100110101011
1011001111000111010100011000100001101000100111101000101000100000110100111000011000011100111101010011
10010000110010110110111101100010010111001111010000110110111001000100001010010111C1001100110100110111
1000001101001010010110110010010101000010111110111100110010110111101011010111111100010110011000100111
1110111001000111100011011110110000100110001101011110111110101100011011110111000100000100111011000011
1111000100001001111010000000101000010000011001100000111100101100110001110110010000111110100011100101
101C000000001010101000010010100001100010010100000001101110110011000110001101111101000111111100111101
1001000110000000000000000000000000000011000011110100001111101010001001000010001000101100000001100101
1011101000100110000111100110011011001111101110100110111101010110111101011001111001001111001100001011
101101000100101001111001111010100110000000000000000000000000C111011110000010110000001010101011001011
1111001100010011010000000001100011000101111010001001001011101100101101001011001000000100101110110011
1110001000011010100010111110110000101010011100010001000110111110111001110011101101110010111011100001
100011001001001100000011001100111000110000111010101000110010110111010T011111111000101110011110011111
110000001100101001000011011001011000011110111101111010000001000101010S000111111101011010001101100111
1000011101101000011000011100111110101001100111110000110101000100011011010000110001000010100100111011
111001001100001101001100111101001100101100000010010010110011110011111K000110011000000100011111101001
1000000010010111010011101011011100101100111111110001111111001111110110100000110001010101001010110101
1111110011101010011110111010100100000010011111001011000101001001000000010001000100000010010100111001
1100101101001010000100011100000101100000110011011101001001110111010011011000101100110000101101111111
1111000000110001001101011100110000001010000111010111011011000110110001111011000001101000110100011011
1111001000101000111010101111010110101010000000111000101001101010101010010100110001100001001110010011
1111000000101101010001011000011100001010110110010110000111011011111111001011011001100010000010110011
1000010001110011000100101110111000000111101010101100101100000100000011100011001000100010111110110111
1000011100101011001101110111100001100000100110011111000100100111101101011011101100100100001010100111
1100010101111111101111001010011110000100010100101001111110000110011100001110010101101100110110111101
1111011101000100101011110010011000101100101101000111011101110100101100000111110000000100101001100111
1101101010111000010100011000110100100111111001100011011010101110101101100100101000111000110010001011
1101010101100000011101010000011010101001100110001001101101111000011011001110111001001000011110011011
1011010101011111110101010001010010100010101000100100010110011000000110110000011100010101111000000011
1100111010010010100001100100111011101100011010000011111010011001001101010000011001011000101111001111
1101110101001000101010101101000100000110011001010101001000111001000111011011100101111101110001010001
1010110111000101011111010111100001000011110011011011001001100101111001110010110100000101011001010111
1010001111100100101011110010111111101011111000010110000100100001111001100001000101101001010101001011
1111101111010111111000110010001011101111110010001110011100010100110001010101001101100100111101010001
1011100011111001101010001100000111001011001000110000101101110000000011000101011100100100111110111111
1010101000011101001011100000000101000001001110110111100001000111110001111111000000100111110000110001
1000010001010001011011110000001001001011111110110000110100011100001011111011010101000000101011000101
1000100001010011011110110100110010101000101100010011111111010011100001111100000100111001101100101011
1101101011011011110111000000111111101000010001011011110100101011010111001010010000110101011001010111
1000001000010001000110101100001000001101101011111101000010010010111111101110101001111011100000000001
1110010111000100010111111001100101001110001011101001100001101011101001000000010000001101111000100011
1111110000011100001010110101011110100110111010110100000001111110011001010111000101100011101110011001
1111010011010110110110111110000011101000001110101100110001100011000101101110100100000101011111111101
1000111111110010110011001010011100101100100100111101101100011101111100010101100000110010110000110111
1010100010110001111101111111111011000101111010100110001110101001111100111000000100110001101000010101
1110101001000111101010110011100111100101011100111110101100111000101001011001100101001000101111011101
1100011111000100000111101101010011100110101110001010001111100101011100000001011101110110000100110101
1010100001C00000000000000000000000000000110001011000101000010100001011000101011101110001101010001101
1000110010100110001010010100011000000000000000000000000000000000001000010001011000010101111001000101
1101000010001000101001111000000111110000010011111011111001001000100110000100001000001111100110010111
110001111110110110000000111010101100011111101100111000011001001100000000000000000000000000C000110111
1011011010100001001010101010101110100100010101001001001000010110101110100001101101101010100010011101
1111110101000010000101111010011001111101001001110001101011000111000000000000000000000011100100000011
1001001010101011111100111110111001001100110011010010000110000101000011001101110101101000011000010111
1011011100100111010110101001010100111110101010100110001110000110101101001100100000101000001010100111
1000111011000000110011010110011000100011010000001101100110110001011110011010000101111101000111010001
1001111111100111111110001100101001111010010110100101100100010111010000100001110001111001001101100001
1110111110100001010101100001100100110001101110010110111110111110011000111100100001111000010011110011
1101011111101110010011110010101010111010111010111100000001011101100001100001000000001011011010010001
1111110001001110100110010001101111110101110000110101100000001001001111110100101101010101100010100111
1100100111000001011101010100000010010101101111010111100111010111001001101101101100101000110110101111
1111011101001110110010101001110110011101001110001011110010100001000110111010100001011011110000110001
10111100011C0011100110101111111111011010111011100110101111011011111110010010000101001000111000000111
1001100011001011010101101100110100001101111111000011100000001000110011011110000001001100101000011011
1110100101110111001101111000100011110011000000101001100111111101110000100001100001100111101110110111
1001100101011000001001011110011100101000011101000110110010101100001001101010100001101100001110111011
1111100010110100011010110000100101100001110101011010111101000011000001110100100100101011101111001111
1101000111010000110100100111100100010110001001010110111010101011101101101001001100000111001010010101
1010000100111010111010000110000000111101010111001001101001001011111100110001101001101110000110001111
1000111010001001001000100011101101110110111011110001001111011011001010111000010101101100100100111111
1011011111110110001101111011000111000101101110000111111010011110000100010011100000111011001110001101
1101010110C00000000000000000000000000000000000000000000000000000000000000000000001111110000101110001
11011011101101001101100111000011100001010110000001001011011110101010111011100101000000000000000E0001
1000010000101001010101100101001101000000011111011100101100011101001111110100110000100110011010010111
1011011000000110000110001101010000110101011011111010000010011011111000101011101001001111000001111011
1011010001101011110100010000000000110111010110011011100000010011100011011101100000001100101111000101
1110001010000110010100110011101111011011110000110111000101010101100101100100100000110000100011100011
1111011011110001110000000101000100110011010011000110011011011001100111001010011010011111011111110001
1001001100010110101100001100010100101110001101111101101101110000101110100011111101101101111000001011
1011111001000011100011010100000001101000100010101001011100011010001101110000100111011101111000101111
1010101011010100100000010001010110010001011011011010000011111101111100100011111000111001111011100101
1001011110010010000000100001110111000000110000100010110001000010001101101110001110000010001100010001
1100110101110100000101000001011101111000110010010011001011100110011000011110010001000111110100011111
1000011010001111100101101010010111110110101001000110001001011001110001111110000100010110001110010111
1000010101111110000011000110111111110111010111111100100101010101111010011100101101111111100101101101
1001101110010100111110001010110010110111101110010000111100000001001010010001011011011100110111011001
1111111010101110000101110000001101010111010110011000000101110100101010011010100000111110011011010001
1000101010100101001010110001110101101110011000110010001110011001100101010110101000110010010011010111
1101011100101010110111011101110111001000111101100110011110000110001111110001101110110110101110001111
1000010010111110000111100000011010111100110000011100010001000000100000101010100110000101111100010101
1001110101000101000010000111110110101001010101111010000000010100011010001001101111110110010100110111
1111111111111111111111111111111111111111111111111111111111111111111111111111111111111111111111111111