111111111111111111111111
1P00000000C0110101111011
11000000110101110001C111
111C10001001001011000101
110000000011011000100011
101100010000000111000011
101110010000000C10110001
111011000011001101000001
111010010000001101000011
111100010000111100000101
100101011010011001110101
110100101010011100100101
100000001000001001110101
11C000000011010110000101
101011100000000000000101
101010010010110000000011
1110101001110000000000C1
100C00000000110001010001
111110001101111101100111
11C000000000000000000011
1100001001010110010SKTE1
101011010010110001110001
101010001010010000001111
111111111111111111111111