11111111111111111111111111111111111111111111111111
1P000000000000000000C00001101111011100101010111011
10110000110110010001001100011011000101000000110111
10101000000110110000100110110110000011011001001001
10110000100010110010110100110011011100011111101111
1010000101101010000100111101100000011100C001001001
10110010101110011000100111110011100000110011101001
100C0000010100001001110001111010100101000101001011
10100000000000000000100100101000001010000100100101
11111110010010000001100110111100110001100011110011
101100100100001010000000000000C1111011100111011101
10001110000100100100000110111101001000100101100101
11011001111110110101010101011111011011100111000101
11001011110011011100101100110111111111000011010101
11110110011010111101111111000101010100000111010001
11011010010110010101111000100000000010000000010101
10101001100100011000110100010011000110000011000111
11101010111111110101000010110011110001000110001001
10011000110100101100001111101110101110010000101011
10100101001111010100001111101000101100100011000111
1010001110000000000001001101101101S000100111110101
1011011001010001010100000001110000K010000010110001
11001000110110110100111110000100111110000010001101
101100101011110000000101011110111T1101100110100101
11111011010010000101100111000010011011100110001111
10011011001011010100110011110011100101100001011101
11110001011011000101111011110101011100010101000001
10010C00000000000001111110001010110001000010101101
10001001110110010000000000000000001000110101000011
11100101001010000001010110101001101010000001001001
110110011100101010011101010010001000000000000C0111
10101001110111011001101101101101100001100110111111
11010101100001010100111000110101101110100111001001
10000001001000101110111010010111101000100110110001
11110100111101111011001110101010011001100011011001
101000C1001010101011011010011001011110000001000111
10101001001010010111100000111001011101000111010101
11001110100000011011000000101110101001010110101001
11101101011100010100010100110000111111000000010111
11011C00000000000000000000000000000000000001101011
111011010000100011100011101101011010000000000000E1
11100001001101001111111011100101010100101101001001
11011001110001101101101010010100000011100001011011
11011010110101000010011111100011010110101100011001
10011010001000010111100110000101101001100001101001
11000100110111001111100001100000010010010001001001
10001001101110011011001110110000100010001110000111
10100101101000101001001111000110011101010011101111
11101101110000001011010101000000110110100111110011
11111111111111111111111111111111111111111111111111