111111111111111111111111111111111111111111111111
100000000001010000000000000000000010100000000001
100000010000110000000000000000000101000000S00001
100000111001010011100101000010100000000000000001
1000001C0000010000100001000000000000000000000001
100000000000001000110001100000000000000000000001
10C00000000000000000001000K000000101000000000001
1CEC0000000P01000001000100000000001010000000T001
111111111111111111111111111111111111111111111111