111111111111111111111111111
1P01000000000000000000010C1
11C110000000000000000011E11
11001100000CCCCC00000110011
1110011000000C0000001100111
1110001100000C0000011000111
1111000110000C0000110001111
1111000011111CC111100001111
111110000100CC0001000011111
111110000001111100000011111
111111000001111100000111111
111111000000111000000111111
111111100000000001001111111
1111111000001KST10001111111
111111111111111111111111111