1111111111111111111111111111111111
10C000E0000000000C00000000P0001111
1111111111111111111111111111111111