111111
1P1101
1C1111
10E111
111111