111111111111111111111111111111111111111111111111
100000000001010000000000000000000010100000000001
10000001000C110000000000000000000101000000000001
100000000001010011100101000000000010100000000001
1000000C0000010000100001000000000010100000000001
100000000000010001100011000000000010100000000001
100000000000000000000001000000000010100000000001
100000E0000P010000010001000000000010100000000001
111111111111111111111111111111111111111111111111