111111111111111111111111111111111111111111111111
100000000001010000000000000000000010100000000001
10000001000C110000000000K00000000101000000S00001
10000011100101001110010100C000000010100000000001
1000001C0000010000100001000000000000000000E00001
100000000000001000110001100000000001010000000001
100000000000000000000010000000000101000000000001
10000T00000P010000010001000000000010100000000001
111111111111111111111111111111111111111111111111