1111111111111111111111111
1P00000000C01111111000101
11100111100000000011C1001
100C110001000110110000101
1100000000110011110100011
1011011110110001100100111
110101000000000C101001011
1000110010110010010101001
1100101110001001101100101
1010101110001010001000001
1010110100001111001000101
1111000010010101100100011
1111001000101111101101111
11C0000000101000111101011
1100011110000000000001001
1000000101111110100000101
10000101000000001000000C1
1000101101001100000101111
110C100111011111110100101
10C0000000000000000000001
11110001010000000011000E1
1000010100111000111111111
1001101011101011011111001
1010100110101111010110011
1111111111111111111111111