111111111111111111111111
100000000001010000000001
10000001000C110000000001
100000000001010011100001
1000000C000P01000E100001
100000000000010001100011
100000000000000000000001
100000000000010000000001
111111111111111111111111