111111111011111111111101
1E0000000000111111111111
101001010010111111CCCC11
101001001010111111111111
111111111111100011111111
11100000111P110000011111
111111111111110000011111
000111000110011000111111
000111000110011000111111