111111111111111111111111
100000000000010000000001
10000000000C010000000001
10000000000C010011100001
10000000000P01001E100001
100000000000010001100001
100000000000010000000001
100000000000010000000001
111111111111111111111111