1111111111111111111111111111111111
1PCCCCCCCCCCCCCCCCCCCCCCCCCCCCCCC1
1111111111111111111111111111111101
1C0C0C0C0C0C0C0C0C0C0C0C0C0C0C0C01
10C0C0C0C0C0C0C0C0C0C0C0C0C0C0C0C1
1011111111111111111111111111111111
101C0C100C0C0C1000100C100C100C0001
1000100C1010100C100C100C100C1100E1
1111111111111111111111111111111111
