111111111111111111
1P1000000000000001
100001110000000001
1010010010000C00E1
111111111111111111