11111111111111111111111111111111111
10C000E0000000000C00000000P00000001
11111111111111111111111111111111111