111111111111111111
1P1000010CC0000001
100001000000000111
1010010010000C0EC1
111111111111111111